1111111111111111
1000000000000001
1011111111100001
1000000000100001
1011111110100001
1000000010100001
1111011010101111
1001001000100001
1011001111100001
1000000000000001
1111111111111111

